1111111111
1P000C0E11
1111111111