1111111111
1P00000EC1
1111111111