1111111111
1P0000CE11
1111111111